SO  #554244
NO #0103ef
WE 0,0,0
EA rgba (02,257,32,0)
F rgba(233,255,255,0)
C 0,0,255
C test.cub





    1111111111111111111111111
    1000000000110000000000001
    1011000001110000000000001
    1001000000000000000000001
111111111011000001110000000000001
10000000H0011000001110111111111111
11110111111111011100000010001
11110111111111011101010010001
110000001101010111000 00010001
10000000000000001100000010001
10000000000000001101010010001
11000001110101011111011110N0111
11110111 1110101 101111010001
11111111 1111111 111111111111























