NO ./textures/north.xpm
SO ./textures/south.xpm
WE ./textures/west.xpm
EA ./textures/east.xpm
F 0,0,0
C 0,0,0

111111111111111111
100000000000000001
100000000000000001
11000000E000000011
100000000000000001
100000000000000001
111111111111111111