NO ./textures/north.png
SO ./textures/south.png
WE ./textures/west.png
EA ./textures/east.png

F 18,53,25
C 153,204,255

111111111111111111
100111100000000001
1011000001100100001
100000000110001001
100000N00110000001
100000001000000101
100010000000001001
111111111111111111